Rhizome
An Interactive Fiction by lizzard
Release 1 / Serial number 190705 / Inform 7 build 6M62 (I6/v6.33 lib 6/12N) SD

Gate to the Mushroom Farm
You have entered the Mushroom Farm by the front gate. The road leads east past a little house.

You can see a hand-painted sign here.

>e
Camp Road
This paved road leads from the western gate to higher ground, to the east. A smaller gravel road winds north over a tiny creek, towards huge derelict warehouses.

You can see a pair of heavy work gloves here.

>n
Overgrown Creek
You cross the bridge over a tiny creek, overgrown with tall plants. Only a trickle of water is visible below.

You can see some tall hemlock, some lacy fennel and some stinging nettles here.

>take hemlock
Taken.

>i
You are carrying:
  some tall hemlock

>drop hemlock
Dropped.

* * *

>e
Camp Road
This paved road leads from the western gate to higher ground, to the east. A smaller gravel road winds north over a tiny creek, towards huge derelict warehouses.

You can see a pair of heavy work gloves here.

>take gloves
Taken.

>n
Overgrown Creek
You cross the bridge over a tiny creek, overgrown with tall plants. Only a trickle of water is visible below.

You can see some tall hemlock, some lacy fennel and some stinging nettles here.

>take nettles
Ouch! You get stung painfully by the nettles, all over your hands!

>i
You are carrying:
  a pair of heavy work gloves

>wear gloves
You put on the pair of heavy work gloves.

>take nettles
Taken.

>i
You are carrying:
  some stinging nettles
  a pair of heavy work gloves (being worn)

* * *

>take nettles
Ouch! You get stung painfully by the nettles, all over your hands!

>wear gloves
You put on the pair of heavy work gloves.

>take all
tall hemlock: Taken.
lacy fennel: Taken.
stinging nettles: [Your score has just gone up by ten points.]

* * *

>take gloves
Taken.

>wear gloves
You put on the pair of heavy work gloves.

>i
You are carrying:
  a pair of heavy work gloves (being worn)

>remove gloves
You take off the pair of heavy work gloves.

>l
Camp Road
This paved road leads from the western gate to higher ground, to the east. A smaller gravel road winds north over a tiny creek, towards huge derelict warehouses.

>x self
As good-looking as ever.

* * *

>take gloves
Taken.

>x gloves
A pair of thick work gloves. They would fit you perfectly!

>wear gloves
You can't wear that!

* * *

Rhizome
An Interactive Fiction by lizzard
Release 1 / Serial number 190705 / Inform 7 build 6M62 (I6/v6.33 lib 6/12N) SD

Gate to the Mushroom Farm
You have entered the Mushroom Farm by the front gate. The road leads east past a little house.

You can see a hand-painted sign here.

>help
Help is available about the following topics. Typing HELP followed by the name of a topic will give further information.

 self: The point of view character
 commands: A list of basic commands in the game
 exits: Using the EXITS command
 score: Things that make your score go up
 bugs: How to report bugs

>help commands
Type "i" to look at your inventory (what you are carrying).  
 "Look" will show you a room description (again). 
 "Exits" will show you a list of possible exits from a room.
 You can "go" in all 8 directions (north, northeast, etc) as well as up and down. 
 "n" is a convenient shorthand for "go north" 
 You can also take things, open things, sit on things, and stand up. 
 "examine" ("x") or "look at" will let you examine an object. Or, sometimes, details in a room description.
 "Hints" will get you a small menu of extra hints, a little spoilery. 
 There are many more commands to try!

>help self
Keep in mind you can type "examine self" or "x self". This might be useful or informative, sometimes.

>help exits
Type "exits" if you want a list of possible exits. It's a little cheaty, but so much less frustrating.

>help score
One point for each new room visited. 5 points for each connection to the land you establish.

* * *

Rhizome
An Interactive Fiction by lizzard
Release 1 / Serial number 190705 / Inform 7 build 6M62 (I6/v6.33 lib 6/12N) SD

Gate to the Mushroom Farm
You have entered the Mushroom Farm by the front gate. The road leads east past a little house.

You can see a hand-painted sign here.

>help sign
You're out of ideas.

>help
Help is available about the following topics. Typing HELP followed by the name of a topic will give further information.

 commands: A list of basic commands in the game
 exits: Using the EXITS command
 self: The point of view character
 score: Things that make your score go up
 bugs: How to report bugs

>help commands
"i" - lists  your inventory (what you are carrying).  
 "Look" or "l" - shows the room description (again). 
 "Exits" - shows a list of possible exits from a room.
 (It's good to type this in every location, routinely.)
 "n" -  convenient shorthand for "go north" 
 "s", "e", "w", "u", "d" - south, east, west, up, down
 "x" - examine something
 "take" - You can also take things, open things, sit on things, and stand up. 
 "Hints" will get you a small menu of extra hints, a little spoilery. 
 There are many more commands to try!

>e
Camp Road
This paved road leads from the western gate to higher ground, to the east. A wide road continues south to the main level of the Farm. A smaller gravel road winds north over a tiny creek, towards huge derelict warehouses. 

You can see a pair of heavy work gloves here.

>t
That's not a verb I recognise.

* * *

Rhizome
An Interactive Fiction by lizzard
Release 1 / Serial number 190705 / Inform 7 build 6M62 (I6/v6.33 lib 6/12N) SD

Gate to the Mushroom Farm
You have entered the Mushroom Farm by the front gate. The road leads east past a little house.

You can see a hand-painted sign here.

>score
You have so far scored 0 out of a possible 0, in 1 turn.

>rea sign
That's not a verb I recognise.

>read sign
Type "help" for some basic commands you can try.

>help
Help is available about the following topics. Typing HELP followed by the name of a topic will give further information.

 self: The point of view character
 commands: A list of basic commands in the game
 exits: Using the EXITS command
 score: Things that make your score go up
 bugs: How to report bugs

* * *

Rhizome
An Interactive Fiction by lizzard
Release 1 / Serial number 190705 / Inform 7 build 6M62 (I6/v6.33 lib 6/12N) SD

Gate to the Mushroom Farm
You have entered the Mushroom Farm by the front gate. The road leads east past a little house.

You can see a hand-painted sign here.

>x house
A well loved looking house full of life and business. You leave them in privacy.

>exits
You can go  from here.